10
15
***************
*e.........****
*******.*******
*******.*******
***.......*****
*****.*********
*****.*********
*****.....*****
*********...o**
***************