5 
5
*****
*...*
*.*e*
*.o**
*****