8
8
********
*e.....*
*****..*
*o..*..*
*.*.**.*
*.*....*
*.*....*
********